Complete Set Reference
Revised July 2025
Method	                        Description

new Set()	                    Creates a new set
add()	                        Adds a new element to a set
clear()	                        Removes all elements from a set
delete()	                    Removes an element from a set
difference()	                Returns the difference between two sets
entries()	                    Returns an Iterator with the [value,value] pairs from a set
forEach()	                    Invokes a callback for each element in a set
has()	                        Returns true if a value exists
intersection()	                Returns the intersection of two sets
isDisjointFrom()	            Returns true if no elements in a set are elements in another set
isSubsetOf()	                Returns true if a set is a subset of another set
isSupersetOf()	                Returns true if a set is a superset of another set
keys()	                        Same as values()
symmetricDifference()	        Returns the symmetric difference between two set
union()	                        Returns the union of two sets
values()	                    Returns an Iterator with the values in a set
Sets have only one property:


Property	    Description

size	        Returns the number of elements in a Set


-------------------------------------------------------------------------

Complete Map Reference
Revised July 2025
Method	                        Description
new Map()	                    Creates a new Map object
clear()	                        Removes all the elements from a Map
delete()	                    Removes a Map element specified by a key
entries()	                    Returns an iterator object with the [key, value] pairs in a Map
forEach()	                    Invokes a callback for each key/value pair in a Map
get()	                        Gets the value for a key in a Map
groupBy()	                    Groups object elements according to returned callback values
has()	                        Returns true if a key exists in a Map
keys()	                        Returns an iterator object with the keys in a Map
set()	                        Sets the value for a key in a Map
size	                        Returns the number of Map elements
values()	                    Returns an iterator object of the values in a Map


-----------------------------------------------
Complete Array Reference
Revised July 2025

Name	                    Description
[ ]	                        Creates a new Array
new Array()	                Creates a new Array
at()	                    Returns an indexed element of an array
concat()	Joins arrays and returns an array with the joined arrays
constructor	Returns the function that created the Array prototype
copyWithin()	Copies array elements within the array, to and from specified positions
entries()	Returns a key/value pair Array Iteration Object
every()	Checks if every element in an array pass a test
fill()	Fill the elements in an array with a static value
filter()	Creates a new array with every element in an array that pass a test
find()	Returns the value of the first element in an array that pass a test
findIndex()	Returns the index of the first element in an array that pass a test
findLast()	Returns the value of the last element in an array that pass a test
findLastIndex()	Returns the index of the last element in an array that pass a test
flat()	Concatenates sub-array elements
flatMap()	Maps all array elements and creates a new flat array
forEach()	Calls a function for each array element
from()	Creates an array from an object
includes()	Check if an array contains the specified element
indexOf()	Search the array for an element and returns its position
isArray()	Checks whether an object is an array
join()	Joins all elements of an array into a string
keys()	Returns a Array Iteration Object, containing the keys of the original array
lastIndexOf()	Search the array for an element, starting at the end, and returns its position
length	Sets or returns the number of elements in an array
map()	Creates a new array with the result of calling a function for each array element
of()	Creates an array from a number of arguments
pop()	Removes the last element of an array, and returns that element
prototype	Allows you to add properties and methods to an Array object
push()	Adds new elements to the end of an array, and returns the new length
reduce()	Reduce the values of an array to a single value (going left-to-right)
reduceRight()	Reduce the values of an array to a single value (going right-to-left)
reverse()	Reverses the order of the elements in an array
shift()	Removes the first element of an array, and returns that element
slice()	Selects a part of an array, and returns the new array
some()	Checks if any of the elements in an array pass a test
sort()	Sorts the elements of an array
splice()	Adds or Removes array elements
toReversed()	Reverses the order of array elements (to a new array)
toSorted()	Sorts the elements of an array (to a new array)
toSpliced()	Adds or Removes array elements (to a new array)
toString()	Converts an array to a string, and returns the result
unshift()	Adds new elements to the beginning of an array, and returns the new length
valueOf()	Returns the primitive value of an array
with()	Returns a new array with updated elements

-----------------------------------------

Complete String Reference
Revised July 2025
Name	Description

at()	Returns an indexed character from a string
charAt()	Returns the character at a specified index (position)
charCodeAt()	Returns the Unicode of the character at a specified index
codePointAt()	Returns the Unicode value at an index (position) in a string
concat()	Returns two or more joined strings
constructor	Returns the string's constructor function
endsWith()	Returns if a string ends with a specified value
fromCharCode()	Returns Unicode values as characters
includes()	Returns if a string contains a specified value
indexOf()	Returns the index (position) of the first occurrence of a value in a string
isWellFormed()	Returns true if a string is well formed
lastIndexOf()	Returns the index (position) of the last occurrence of a value in a string
length	Returns the length of a string
localeCompare()	Compares two strings in the current locale
match()	Searches a string for a value, or a regular expression, and returns the matches
matchAll()	Searches a string for a value, or a regular expression, and returns the matches
padEnd()	Pads a string at the end
padStart()	Pads a string from the start
prototype	Allows you to add properties and methods to an object
repeat()	Returns a new string with a number of copies of a string
replace()	Searches a string for a pattern, and returns a string where the first match is replaced
replaceAll()	Searches a string for a pattern and returns a new string where all matches are replaced
search()	Searches a string for a value, or regular expression, and returns the index (position) of the match
slice()	Extracts a part of a string and returns a new string
split()	Splits a string into an array of substrings
startsWith()	Checks whether a string begins with specified characters
substr()	Deprecated. Use substring() or slice() instead.
substring()	Extracts characters from a string, between two specified indices (positions)
toLocaleLowerCase()	Returns a string converted to lowercase letters, using the host's locale
toLocaleUpperCase()	Returns a string converted to uppercase letters, using the host's locale
toLowerCase()	Returns a string converted to lowercase letters
toString()	Returns a string or a string object as a string
toUpperCase()	Returns a string converted to uppercase letters
toWellFormed()	Returns a string where "lone surrogates" are replaced with the Unicode replacement character
trim()	Returns a string with removed whitespaces
trimEnd()	Returns a string with removed whitespaces from the end
trimStart()	Returns a string with removed whitespaces from the start
valueOf()	Returns the primitive value of a string or a string object


------------------------------------

JavaScript Date Methods and Properties
Revised July 2025
Name	                            Description

new Date()	                Creates a new Date object
constructor	                Creates a new Date object
constructor	                Returns the function that created the Date prototype
getDate()	                Returns the day of the month (from 1-31)
getDay()	                Returns the day of the week (from 0-6)
getFullYear()	            Returns the year
getHours()	                Returns the hour (from 0-23)
getMilliseconds()	        Returns the milliseconds (from 0-999)
getMinutes()	            Returns the minutes (from 0-59)
getMonth()	                Returns the month (from 0-11)
getSeconds()	            Returns the seconds (from 0-59)
getTime()	                Returns the number of milliseconds since midnight Jan 1 1970, and a specified date
getTimezoneOffset()	        Returns the time difference between UTC time and local time, in minutes
getUTCDate()	            Returns the day of the month, according to universal time (from 1-31)
getUTCDay()	                Returns the day of the week, according to universal time (from 0-6)
getUTCFullYear()	        Returns the year, according to universal time
getUTCHours()	            Returns the hour, according to universal time (from 0-23)
getUTCMilliseconds()	    Returns the milliseconds, according to universal time (from 0-999)
getUTCMinutes()	            Returns the minutes, according to universal time (from 0-59)
getUTCMonth()	            Returns the month, according to universal time (from 0-11)
getUTCSeconds()         	Returns the seconds, according to universal time (from 0-59)
getYear()               	Deprecated. Use the getFullYear() method instead
now()	                    Returns the number of milliseconds since midnight Jan 1, 1970
parse()                 	Parses a date string and returns the number of milliseconds since January 1, 1970
prototype	                Allows you to add properties and methods to an object
setDate()	                Sets the day of the month of a date object
setFullYear()	            Sets the year of a date object
setHours()	                Sets the hour of a date object
setMilliseconds()	        Sets the milliseconds of a date object
setMinutes()	            Set the minutes of a date object
setMonth()	                Sets the month of a date object
setSeconds()	            Sets the seconds of a date object
setTime()	                Sets a date to a specified number of milliseconds after/before January 1, 1970
setUTCDate()	            Sets the day of the month of a date object, according to universal time
setUTCFullYear()	        Sets the year of a date object, according to universal time
setUTCHours()	            Sets the hour of a date object, according to universal time
setUTCMilliseconds()	    Sets the milliseconds of a date object, according to universal time
setUTCMinutes()	            Set the minutes of a date object, according to universal time
setUTCMonth()	            Sets the month of a date object, according to universal time
setUTCSeconds()	            Set the seconds of a date object, according to universal time
setYear()	                Deprecated. Use the setFullYear() method instead
toDateString()	            Converts the date portion of a Date object into a readable string
toGMTString()	            Deprecated. Use the toUTCString() method instead
toISOString()	            Returns the date as a string, using the ISO standard
toJSON()	                Returns the date as a string, formatted as a JSON date
toLocaleDateString()	    Returns the date portion of a Date object as a string, using locale conventions
toLocaleTimeString()	    Returns the time portion of a Date object as a string, using locale conventions
toLocaleString()	        Converts a Date object to a string, using locale conventions
toString()	                Converts a Date object to a string
toTimeString()	            Converts the time portion of a Date object to a string
toUTCString()	            Converts a Date object to a string, according to universal time
UTC()	                    Returns the number of milliseconds in a date since midnight of January 1, 1970, according to UTC time
valueOf()	                Returns the primitive value of a Date object